1111111111
10P0CECV01
1111111111