


111111111111111111111111
100M00000000000000M00001
1000000C0000000EP0111111
100C00000000000000000001
10000000M000000000000001
100000000000000000000001
100000000000000000000001
100000000000000000000001
1000000000000M00000M0001
100000011100000000000001
1000000001M0000000000001
111111111111111111111111