


111111111111111111111111
100000000000000000000001
1000000C0000E00000000001
100C00000000000000000001
10000000V000000000000001
100000000000000000000001
100000000000000000000001
100000000000000000000001
100000000000000000000001
100000000000000000000001
10000000P000000000000001
111111111111111111111111