


111111111111111111111111
100000000000000000100001
1000000C0000E00000111111
100C00000000000000000001
10000000V000000000000001
100000000000000000000001
100000000000000000000001
100000000000000000000001
100000000000000000000001
100000011100000000000001
10000000P1M0000000000001
111111111111111111111111