11111
100P1
10001
100E1
11111
