11111
1C0P1
10001
100E1
11111
